another	kh·c
apple	qu·∫£ t√°o
baby	em b√©
bad	t·ªìi
basic	c∆° b·∫£n
believer	ni·ª?m tin
boy	c·∫≠u b√©
clone	b·∫£n sao
copy	sao ch√©p
cut	c·∫Øt
data	d·ªØ li·ªáu
date	ng√†y
delete	x√≥a
demon	ma qu·ª∑
diamond	kim c∆∞∆°ng
dragon	r·ªìng
easy	ƒë∆°n gi·∫£n
eight	s·ªë t√°m
five	s·ªë nƒÉm
four	s·ªë b·ªën
game	tr√≤ ch∆°i
good	t·ªët
happy	h·∫°nh ph√∫c
hi	xin ch√†o
house	ng√¥i nh√†
legend	huy?n tho?i
monster	qu√°i v·∫≠t
natural	t·ª± nhi√™n
next	ti·∫øp theo
nine	s·ªë ch√≠n
one	s·ªë m·ªôt
search	t√¨m ki·∫øm
seven	s·ªë b·∫£y
six	s·ªë s√°u
song	b√†i h√°t
ten	s·ªë m∆∞·ª?i
three	s·ªë ba
two	s·ªë hai
water	n∆∞·ªõc
year	nƒÉm
zero	s·ªë kh√¥ng
